XXXXXXXXXXXXXXXXXXXXXXXXXXXXXXXX
X..............................X
X..............................X
X..............................X
X..... ........................X
X.........XXXXXXXXX............X
X..............................X
X..............................X
X..............................X
X............... ..............X
X............S.................X
X..............................X
X..............................X
X.............XXXXXXXXX........X
X..............................X
X..............................X
X..............................X
XXXXXXXXXXXXXXXXXXXXXXXXXXXXXXXX